####################
##                G#
# #                #
#  #               #
#   #              #
#    #             #
#     #            #
#                  #
#                  #
#                  #
#                  #
#                  #
#                  #
#            #     #
#             #    #
#              #   #
#               #  #
#                # #
#P                ##
####################