####################
##                ##
# #              # #
#  #            #  #
#   #          #   #
#    #        #    #
#     #      #     #
#                  #
#                  #
#                  #
#       P G        #
#                  #
#                  #
#     #      #     #
#    #        #    #
#   #          #   #
#  #            #  #
# #              # #
##                ##
####################