####################
# ################ #
#  ##############  #
#                  #
#    #        #    #
#                  #
#        #         #
#        #         #
#        #         #
#       P#         #
#    ##########    #
#        #G        #
#        #         #
#        #         #
#                  #
#   #         #    #
#                  #
#  ##############  #
# ################ #
####################