####################
#########          #
##                 #
##                 #
##                 #
#                  #
#                  #
#                  #
#                  #
#                  #
#                  #
#             #    #
#             #    #
#             #    #
#             #    #
#             #    #
#P   ##########   G#
#                  #
#                  #
####################