####################
#                  #
#                  #
#  ##############  #
#                  #
#                  #
#                  #
#  ##############  #
#                  #
#                  #
#                  #
#  ##############  #
#                  #
#                  #
#                  #
######        ######
#                  #
######        ######
#P                G#
####################