####################
#                  #
#                  #
#           P      #
#           #      #
#                  #
#                  #
#                  #
#                  #
#                  #
#                  #
#             #    #
#                  #
#                  #
#                  #
#                  #
#       #          #
#       G          #
#                  #
####################