####################
####################
#P                 #
#                  #
######        ######
#                  #
#                  #
#                  #
######        ######
#                  #
#                  #
#                  #
######        ######
#                  #
#                  #
######        ######
#                  #
#                 G#
####################
####################